005005005005005005004004004004004005005005005005
005005005005005005004004004004005005005006005005
005005005005005004004004004004005005005005005005
005005005005004004004004006005006005006005006005
005005004004004004004006006005005005006005006005
004004004004004006005006006010010010010006005006
004004004006006006006006010010010010010010006006
005006006006006006006006010010010010010010006006
010010010010010010010010010010010010010010006006
005005006006006006006006010010010010010010006006
005005005006006006006006006010010010010006006006
006006005006006006006006006006006006006006006006
006005005005005006006006006006006006006006006006


