002002002002002002002002002002002002
002009009009009009009009009009002002
002009009009009009009009009009002002
002009009009009009009009009009002002
002009009009009009009009009009002002
002002002009002002002002002002002002









