017017017012012012012114113113113113113113113118
017017017011011011011024024024024024024024024116
017017102002013002002006006024024024024024024116
017017117115010111112006006006006021006021024116
017017116006010006006006006006006006006021006101
017006006006010006021006006006021006018103103103
017017116006010006006006006006021018107108105105
017017116006010007006021006018103107108019006116
017017116006001014007006018108105105019006006116
017017101006006001014007106019021021006006006101
017017102101006006001014009010010010010010010010
017017017102101006006018104006006006006006006116
017017017017102114115106104114113113113113113118


