101101101101101101106004104101101101101101101101101017006006006006006006010010010010010010006101
101017017017017018107004104006017017017006017101101017006006006006006006010010010010010010006101
101017017017018107004108019006017017017017017101101017006006006006006006010010010010010010006101
103103103103107004108019006017006017006017006006006006006006006006006006010010010010010010006101
105105110004004108019006006017017017006017006101101017006006006006006006010010010010010010006101
101006020105105019017006006101101101101006017101101017006006006006006006010010010010010010006101
101006006006006006006006010010111112010010006101101017006006006006006006010010010010010010006101
101006006006006006006006010010010010010010006101101017006006006006006006010010010010010010006101
010010010010010010010010010010010010010010006101101017006006006006006006010010010010010010006101
101017006006006006006006010010010010010010006101101017006006006006006006010010010010010010006101
101017017006006006006006006010010010010006006101101017006006006006006006010010010010010010006101
101006017006006006006006006006006006006006006101101017006006006006006006010010010010010010006101
101101101101101101101101101101101101101006101101101017006006006006006006010010010010010010006101
101101101101101101106004104101101101101006101101101017006006006006006006010010010010010010006101
101017017017017018107004104006017017017006017101101017006006006006006006010010010010010010006101
101017017017018107004108019006017017017017017101101017006006006006006006010010010010010010006101
103103103103107004108019006017006017006017006101101017006006006006006006010010010010010010006101
105105110004004108019006006017017017006017006101101017006006006006006006010010010010010010006101
101006020105105019017006006101101101101006017101101017006006006006006006010010010010010010006101
101006006006006006006006010010111112010010006101101017006006006006006006010010010010010010006101
101006006006006006006006010010010010010010006101101017006006006006006006010010010010010010006101
010010010010010010010010010010010010010010006101101017006006006006006006010010010010010010006101
101017006006006006006006010010010010010010006101101017006006006006006006010010010010010010006101
101017017006006006006006006010010010010006006101101017006006006006006006010010010010010010006101
101006017006006006006006006006006006006006006101101017006006006006006006010010010010010010006101
101101101101101101101101101101101101006101101101101017006006006006006006010010010010010010006101
101101101101101101106004104101101101101006101101101017006006006006006006010010010010010010006101
101017017017017018107004104006017017017006017101101017006006006006006006010010010010010010006101
101017017017018107004108019006017017017017017101101017006006006006006006010010010010010010006101
103103103103107004108019006017006017006017006101101017006006006006006006010010010010010010006101
105105110004004108019006006017017017006017006101101017006006006006006006010010010010010010006101
101006020105105019017006006101101101101006017101101017006006006006006006010010010010010010006101
101006006006006006006006010010111112010010006101101017006006006006006006010010010010010010006101
101006006006006006006006010010010010010010006101101017006006006006006006010010010010010010006101
010010010010010010010010010010010010010010006101101017006006006006006006010010010010010010006101
101017006006006006006006010010010010010010006101101017006006006006006006010010010010010010006101
101017017006006006006006006010010010010006006101101017006006006006006006010010010010010010006101
101006017006006006006006006006006006006006006101101017006006006006006006010010010010010010006101
101101101101101101101101101101101101006101101101101017006006006006006006010010010010010010006101



